1,1,1,1,1,1,1,1,1,1,1,1,1,1,1
1,0,0,0,0,0,0,1,1,0,0,0,1,0,1
1,1,1,1,1,1,0,1,0,0,1,0,0,0,1
1,0,0,0,3,1,0,0,0,1,1,1,1,0,1
1,0,1,1,1,1,0,1,0,0,0,1,0,0,1
1,0,0,0,0,0,0,1,0,1,0,0,0,0,1
1,1,1,1,1,1,1,1,4,1,1,1,1,1,1
16,0,0,0,0,0,0,0,5,0,0,0,0,0,1
1,0,1,1,1,1,1,1,5,0,0,1,1,1,1
1,0,0,0,0,0,0,0,5,0,0,0,0,0,1
1,1,1,1,1,1,1,1,5,0,1,1,1,0,1
1,0,0,0,0,0,0,0,4,0,0,0,0,0,1
1,0,1,1,1,1,1,1,1,1,0,1,1,1,1
1,0,0,0,0,0,9,9,9,0,0,0,0,2,1
1,1,1,1,1,1,1,1,1,1,1,1,1,1,1

