1,1,1,1,1,1,1,1,1,1,1,1,1,1,1
1,0,0,0,0,0,0,1,1,0,0,0,1,0,1
1,1,1,1,1,1,0,1,0,0,1,0,0,0,1
1,0,0,0,3,1,0,0,0,1,1,1,1,0,1
1,0,1,1,31,1,0,1,0,0,0,1,0,0,1
1,0,0,0,0,0,0,1,0,1,0,0,0,0,1
1,1,1,1,1,1,1,1,6,1,1,1,1,1,1
1,0,0,0,0,0,0,0,5,0,0,0,0,0,1
1,0,1,1,1,1,1,1,5,0,0,1,1,1,1
1,0,0,0,0,0,0,0,5,0,0,0,0,0,1
1,1,1,1,1,1,1,1,5,0,1,1,1,0,1
1,0,0,0,0,0,0,0,4,0,0,0,0,0,1
1,0,1,1,1,1,1,1,1,1,0,1,1,1,1
1,0,0,0,0,0,0,0,0,0,0,0,0,2,1
1,1,1,1,1,1,1,1,1,1,1,1,1,21,1

