0,0,0,0,0,0,0,0,0,0,0,0,0,0,0
0,0,0,0,0,0,0,0,0,0,0,0,0,0,0
0,0,0,0,0,0,0,0,0,0,0,0,0,0,0
0,0,0,1,1,1,1,1,1,1,1,1,0,0,0
0,0,0,1,9,0,0,0,9,1,33,1,0,0,0
0,0,0,1,0,1,0,1,0,0,0,1,0,0,0
0,0,0,1,0,1,0,1,1,1,1,1,0,0,0
0,0,0,1,0,1,0,1,0,1,0,1,0,0,0
0,0,0,1,0,1,0,0,0,0,0,1,0,0,0
0,0,0,1,0,1,1,1,1,1,1,1,0,0,0
0,0,0,1,9,0,0,0,0,0,2,1,0,0,0
0,0,0,1,1,1,1,1,1,1,1,1,0,0,0
0,0,0,0,0,0,0,0,0,0,0,0,0,0,0
0,0,0,0,0,0,0,0,0,0,0,0,0,0,0
0,0,0,0,0,0,0,0,0,0,0,0,0,0,0
