1,1,1,1,1,1,1,1,1,1,1,1,1,1,1
1,1,1,0,0,0,9,9,0,0,0,36,1,1,1
1,1,1,16,0,0,0,0,0,0,0,0,1,1,1
1,1,1,0,0,0,0,0,9,9,0,4,1,1,1
1,1,1,16,0,1,1,1,1,1,1,5,1,1,1
1,1,1,0,0,1,1,1,1,1,1,5,1,1,1
1,1,1,0,0,0,9,23,26,0,2,5,1,1,1
1,1,1,16,0,0,0,0,0,0,36,5,1,1,1
1,1,1,0,0,0,5,9,0,6,6,5,1,1,1
1,1,1,0,0,1,1,1,1,1,1,5,1,1,1
1,1,1,0,0,1,1,1,1,1,1,5,1,1,1
1,1,1,0,0,0,0,26,26,26,26,4,1,1,1
1,1,1,16,0,0,4,5,5,5,4,0,1,1,1
1,1,1,6,0,9,9,6,6,6,6,36,1,1,1
1,1,1,1,1,1,1,1,1,1,1,1,1,1,1
