1,1,1,1,1,1,1,1,1,1,1,1,1,1,1
1,0,0,0,0,0,0,1,1,0,0,0,1,0,1
1,1,1,1,1,1,0,1,0,0,1,0,0,0,1
1,0,0,0,3,1,0,0,0,1,1,1,1,0,1
1,0,1,1,1,1,0,1,0,0,0,1,0,0,1
1,0,0,0,0,0,0,1,0,1,0,0,0,0,1
1,1,1,1,0,1,1,1,4,1,1,1,1,1,1
1,0,0,0,0,0,0,0,5,0,0,0,0,0,1
1,0,1,1,1,1,1,1,5,0,0,1,1,1,1
1,0,0,0,0,0,0,0,5,0,0,4,5,4,1
1,1,1,1,1,1,1,1,5,0,1,1,0,0,1
1,0,0,0,0,0,0,0,4,0,0,0,0,0,1
1,0,1,0,1,1,1,1,1,1,0,1,1,7,1
1,0,0,0,0,0,9,9,9,0,0,2,0,0,1
1,1,1,1,1,1,1,1,1,1,1,1,1,1,1

